"a" = (/turf/closed/wall/mineral/rogue/roofwall/treewall/innercorner,/area/rogue/indoors/shelter)
"b" = (/obj/structure/mineral_door/wood/deadbolt{dir = 1},/turf/open/floor/rogue/ruinedwood/herringbone,/area/rogue/indoors/shelter)
"c" = (/obj/structure/bed/rogue/double/tree,/obj/item/bedsheet/rogue/tree_double,/turf/open/floor/rogue/ruinedwood,/area/rogue/indoors/shelter)
"d" = (/turf/closed/wall/mineral/rogue/roofwall/treewall{dir = 8},/area/rogue/indoors/shelter)
"e" = (/turf/closed/wall/mineral/rogue/roofwall/treewall{dir = 1},/area/rogue/indoors/shelter)
"f" = (/obj/structure/chair/wood/rogue/tree{dir = 1},/turf/open/floor/rogue/ruinedwood/herringbone,/area/rogue/indoors/shelter)
"g" = (/obj/structure/stairs{dir = 1},/turf/open/floor/rogue/ruinedwood/herringbone,/area/rogue/indoors/shelter)
"i" = (/turf/closed/wall/mineral/rogue/roofwall/treewall/innercorner{dir = 8},/area/rogue/indoors/shelter)
"j" = (/obj/structure/fluff/railing/border{dir = 5},/turf/open/floor/rogue/ruinedwood/herringbone,/area/rogue/indoors/shelter)
"l" = (/obj/structure/rack/rogue/shelf/tree,/obj/structure/fluff/railing/border,/obj/structure/rack/rogue/shelf/big/tree,/turf/open/floor/rogue/ruinedwood/herringbone,/area/rogue/indoors/shelter)
"p" = (/turf/closed/wall/mineral/rogue/roofwall/treewall/outercorner,/area/rogue/indoors/shelter)
"r" = (/obj/structure/rack/rogue/shelf/tree,/obj/structure/rack/rogue/shelf/biggest/tree,/turf/open/floor/rogue/ruinedwood/herringbone,/area/rogue/indoors/shelter)
"t" = (/obj/machinery/light/rogue/wallfire/candle/tree/directional/east,/turf/open/floor/rogue/ruinedwood/herringbone,/area/rogue/indoors/shelter)
"v" = (/obj/structure/roguewindow/openclose/tree{dir = 4},/turf/open/floor/rogue/ruinedwood/herringbone,/area/rogue/indoors/shelter)
"w" = (/turf/closed/wall/mineral/rogue/roofwall/treewall{dir = 4},/area/rogue/indoors/shelter)
"x" = (/turf/closed/wall/mineral/rogue/roofwall/treewall/innercorner{dir = 1},/area/rogue/indoors/shelter)
"z" = (/obj/structure/chair/wood/rogue/tree{dir = 8},/turf/open/floor/rogue/ruinedwood/herringbone,/area/rogue/indoors/shelter)
"A" = (/turf/open/floor/rogue/ruinedwood/herringbone,/area/rogue/indoors/shelter)
"B" = (/turf/closed/wall/mineral/rogue/roofwall/treewall/outercorner{dir = 4},/area/rogue/indoors/shelter)
"C" = (/obj/structure/chair/wood/rogue/tree,/turf/open/floor/rogue/ruinedwood/herringbone,/area/rogue/indoors/shelter)
"D" = (/obj/machinery/light/rogue/wallfire/candle/tree/directional/west,/turf/open/floor/rogue/ruinedwood/herringbone,/area/rogue/indoors/shelter)
"H" = (/turf/closed/wall/mineral/rogue/roofwall/treewall/outercorner{dir = 8},/area/rogue/indoors/shelter)
"I" = (/obj/structure/roguewindow/openclose/tree{dir = 1},/turf/open/floor/rogue/ruinedwood/herringbone,/area/rogue/indoors/shelter)
"J" = (/obj/structure/fluff/railing/border{dir = 4},/turf/open/floor/rogue/ruinedwood/herringbone,/area/rogue/indoors/shelter)
"L" = (/turf/closed/wall/mineral/rogue/roofwall/treewall/innercorner{dir = 4},/area/rogue/indoors/shelter)
"O" = (/obj/structure/roguewindow/openclose/tree{dir = 8},/turf/open/floor/rogue/ruinedwood,/area/rogue/indoors/shelter)
"P" = (/turf/open/floor/rogue/ruinedwood,/area/rogue/indoors/shelter)
"S" = (/obj/structure/closet/crate/chest/crate/tree,/turf/open/floor/rogue/ruinedwood,/area/rogue/indoors/shelter)
"T" = (/obj/structure/table/wood/tree,/turf/open/floor/rogue/ruinedwood/herringbone,/area/rogue/indoors/shelter)
"U" = (/turf/closed/wall/mineral/rogue/roofwall/treewall/outercorner{dir = 1},/area/rogue/indoors/shelter)
"X" = (/turf/template_noop,/area/template_noop)
"Z" = (/obj/machinery/light/rogue/oven/tree/south,/obj/structure/fluff/railing/border{dir = 6},/turf/open/floor/rogue/ruinedwood/herringbone,/area/rogue/indoors/shelter)

(1,1,1) = {"
XUeeeBX
UxrZlLB
dCAJPcw
vTzJPPO
dfAJgSw
HiDjtap
XHIbIpX
"}
