"a" = (/turf/closed/wall/mineral/rogue/roofwall/treewall,/area/rogue/indoors/shelter)
"c" = (/obj/structure/roguewindow/openclose/tree{dir = 4},/turf/open/floor/rogue/ruinedwood/herringbone,/area/rogue/indoors/shelter)
"e" = (/turf/closed/wall/mineral/rogue/roofwall/treewall{dir = 1},/area/rogue/indoors/shelter)
"i" = (/obj/structure/chair/wood/rogue/tree,/obj/structure/rack/rogue/shelf/tree,/turf/open/floor/rogue/ruinedwood/herringbone,/area/rogue/indoors/shelter)
"l" = (/turf/closed/wall/mineral/rogue/roofwall/treewall/outercorner{dir = 1},/area/rogue/indoors/shelter)
"p" = (/obj/structure/chair/wood/rogue/tree{dir = 1},/turf/open/floor/rogue/ruinedwood/herringbone,/area/rogue/indoors/shelter)
"s" = (/obj/structure/mineral_door/wood/deadbolt{dir = 1; locked = 0},/turf/open/floor/rogue/ruinedwood/herringbone,/area/rogue/indoors/shelter)
"u" = (/obj/machinery/light/rogue/oven/tree/south,/turf/open/floor/rogue/ruinedwood/herringbone,/area/rogue/indoors/shelter)
"y" = (/turf/closed/wall/mineral/rogue/roofwall/treewall{dir = 4},/area/rogue/indoors/shelter)
"z" = (/obj/structure/rack/rogue/shelf/big/tree,/turf/open/floor/rogue/ruinedwood/herringbone,/area/rogue/indoors/shelter)
"C" = (/obj/structure/closet/crate/chest/crate/tree,/turf/open/floor/rogue/ruinedwood/herringbone,/area/rogue/indoors/shelter)
"D" = (/turf/closed/wall/mineral/rogue/roofwall/treewall/outercorner{dir = 4},/area/rogue/indoors/shelter)
"H" = (/turf/closed/wall/mineral/rogue/roofwall/treewall/outercorner,/area/rogue/indoors/shelter)
"K" = (/obj/structure/bed/rogue/inn/wooldouble,/obj/item/bedsheet/rogue/double_pelt,/turf/open/floor/rogue/ruinedwood/herringbone,/area/rogue/indoors/shelter)
"M" = (/obj/structure/roguewindow/openclose/tree{dir = 8},/turf/open/floor/rogue/ruinedwood/herringbone,/area/rogue/indoors/shelter)
"P" = (/obj/structure/table/wood/tree,/turf/open/floor/rogue/ruinedwood/herringbone,/area/rogue/indoors/shelter)
"Q" = (/turf/open/floor/rogue/ruinedwood/herringbone,/area/rogue/indoors/shelter)
"R" = (/turf/closed/wall/mineral/rogue/roofwall/treewall/outercorner{dir = 8},/area/rogue/indoors/shelter)
"Y" = (/turf/closed/wall/mineral/rogue/roofwall/treewall{dir = 8},/area/rogue/indoors/shelter)

(1,1,1) = {"
leeeD
Yiuzy
cPQKM
YpQCy
RasaH
"}
